



1 1 1 1 1 1 1 1 1 1 1 1 1 1 1 1 1 1 1 1
1 0 0 4 0 0 1 0 0 0 0 0 0 0 0 4 0 0 X 3
1 0 0 0 0 0 1 0 0 4 0 0 4 0 0 0 0 0 0 1
1 0 4 1 0 0 1 1 1 1 0 0 1 1 1 1 1 1 1 1
1 0 0 1 0 0 0 0 G 1 0 0 0 0 0 0 0 0 4 1
1 4 0 1 0 0 0 0 B 1 4 0 4 0 0 0 4 0 0 1
1 0 0 1 0 5 0 0 R 1 0 0 0 0 0 1 0 0 0 1
1 0 4 1 0 1 1 1 1 1 0 0 0 4 0 1 0 0 $ 1
1 0 0 1 0 0 0 4 0 1 4 0 0 0 0 1 4 0 * 1
1 9 0 1 0 4 0 0 0 1 0 0 1 1 1 1 0 0 + 1
1 0 0 1 1 1 4 0 0 4 0 0 1 0 0 0 0 0 0 1
2 6 0 1 0 0 0 0 0 0 0 4 1 0 0 0 0 0 0 1
1 1 1 1 1 1 1 1 1 1 1 1 1 1 1 1 1 1 1 1

1 1 1 1 1 1 1 1 1 1 1 1 1 1 1 1 1 1 1 1
1 $ 0 0 0 0 0 0 0 0 0 1 0 0 4 0 0 0 0 1
1 0 4 0 0 4 0 0 0 0 0 1 0 0 0 0 0 0 0 1
1 4 4 0 0 1 0 4 0 0 0 0 0 0 0 4 1 0 0 1
1 0 0 0 0 1 0 0 0 0 4 0 4 0 0 0 1 0 0 1
1 8 Y 0 4 1 1 0 4 0 0 0 0 0 0 4 1 0 0 1
1 0 0 0 0 0 1 0 0 0 0 0 0 0 0 4 1 0 4 1
1 0 4 0 0 0 1 0 0 0 4 1 4 0 0 0 1 0 0 1
1 0 0 0 4 0 1 0 0 0 0 1 0 0 4 0 1 0 0 1
1 1 1 1 1 1 1 0 4 0 0 1 0 0 0 0 1 0 0 1
1 0 0 0 0 0 4 0 0 0 0 1 0 $ 0 0 1 4 0 1
2 6 0 4 0 0 0 0 0 0 9 1 0 0 0 0 1 0 X 3
1 1 1 1 1 1 1 1 1 1 1 1 1 1 1 1 1 1 1 1

1 1 1 1 1 1 1 1 3 1 1 1 1 1 1 1 1 1 1 1
1 0 0 0 0 0 1 0 X < 0 0 0 0 0 0 0 0 0 1
1 4 0 4 0 0 1 1 1 1 1 1 1 1 1 1 1 0 0 1
1 0 0 1 0 4 1 0 0 0 0 0 0 $ 0 4 1 4 0 1
1 0 0 1 0 0 1 0 0 4 0 0 0 0 0 0 0 0 0 1
1 0 5 1 0 0 1 1 1 1 1 1 1 0 4 0 0 0 0 1
1 0 4 1 4 0 1 0 4 0 4 0 4 0 0 0 5 0 0 1
1 0 0 1 0 0 1 0 0 0 0 0 0 0 0 0 0 0 0 1
1 0 0 1 0 0 1 0 4 0 0 0 5 0 0 0 0 4 0 1
1 0 0 1 0 5 1 0 0 0 0 0 0 0 0 0 1 0 0 1
1 0 0 1 0 0 0 0 0 1 1 1 1 1 1 1 1 0 0 1
2 6 0 1 $ 0 0 0 4 1 0 0 0 0 0 0 0 0 4 1
1 1 1 1 1 1 1 1 1 1 1 1 1 1 1 1 1 1 1 1



1 1 1 1 1 1 1 1 1 1 1 1 1 1 3 1 1 1 1 1
1 0 0 0 0 0 5 0 0 1 0 0 0 0 X 5 0 0 4 1
1 S H 0 0 1 0 0 0 1 0 0 0 0 0 0 0 0 0 1
1 O M 0 0 1 0 0 0 1 0 0 0 0 0 0 0 0 0 1
1 P 0 0 0 1 0 0 0 1 0 4 0 0 0 0 0 0 0 1
1 1 1 1 1 1 0 0 0 1 0 0 0 0 0 0 0 0 0 1
1 4 0 9 0 0 0 0 0 1 0 0 0 0 0 0 0 0 4 1
1 0 0 0 0 0 0 0 0 1 1 1 1 1 1 0 0 0 0 1
1 0 0 0 0 0 0 0 0 0 0 5 0 0 0 0 0 0 0 1
1 0 0 0 0 0 0 0 0 0 0 0 0 0 0 0 0 0 4 1
1 0 0 0 0 0 0 0 0 0 0 0 0 0 0 0 0 0 0 1
2 6 0 0 5 0 0 0 0 0 0 0 0 0 0 0 0 0 0 1
1 1 1 1 1 1 1 1 1 1 1 1 1 1 1 1 1 1 1 1

1 3 1 1 1 1 1 1 1 1 1 1 1 1 1 1 1 1 1 1
1 X 0 0 4 0 0 0 0 0 0 0 0 4 0 0 0 4 0 1
1 0 4 0 0 0 4 0 0 4 0 0 0 0 0 4 0 0 0 1
1 1 1 1 1 1 0 0 0 0 0 1 0 0 0 0 0 4 4 1
1 0 0 0 0 1 0 0 0 0 0 1 0 0 0 4 0 0 0 1
1 0 0 0 0 1 0 4 0 4 0 1 0 0 0 0 0 0 0 1
1 0 4 0 0 1 0 0 0 0 0 1 0 4 0 0 0 4 0 1
1 0 0 0 0 1 0 Y 4 0 0 1 0 0 0 4 0 0 0 1
1 0 0 0 0 1 0 8 0 0 0 1 4 0 0 0 0 0 0 1
1 0 0 4 0 1 0 0 0 0 0 1 0 0 0 0 0 0 0 1
1 0 0 0 0 1 1 1 1 1 1 1 1 1 0 0 0 4 0 1
2 6 0 0 0 0 0 0 0 0 0 0 0 0 0 4 0 0 0 1
1 1 1 1 1 1 1 1 1 1 1 1 1 1 1 1 1 1 1 1

1 2 1 1 1 1 1 1 1 1 1 1 1 1 1 1 1 1 1 1
1 6 1 4 0 0 0 0 0 0 1 0 4 0 0 0 0 0 X 3
1 0 1 0 0 0 0 0 = 0 1 0 0 4 0 4 1 1 1 1
1 0 1 0 0 4 0 0 0 0 0 0 0 0 0 0 0 0 0 1
1 0 1 4 0 0 0 1 0 0 0 0 4 0 0 0 4 0 0 1
1 0 1 0 0 0 4 1 4 0 4 0 0 0 4 0 0 0 4 1
1 0 1 0 0 1 1 1 1 1 1 1 1 1 1 1 1 1 1 1
1 0 1 0 0 0 0 0 0 4 0 0 0 4 0 0 0 4 0 1
1 0 1 4 5 0 0 0 0 0 0 4 0 0 0 0 0 0 0 1
1 0 1 1 1 1 1 1 1 1 1 1 1 1 1 1 1 0 0 1
1 0 0 4 0 0 0 4 0 0 0 0 0 0 0 4 0 0 0 1
1 4 0 0 0 0 0 0 0 4 0 0 0 4 0 0 0 0 4 1
1 1 1 1 1 1 1 1 1 1 1 1 1 1 1 1 1 1 1 1



1 1 1 1 1 1 1 1 1 1 1 1 1 1 1 1 1 1 1 1
1 4 0 0 0 0 0 0 0 0 0 0 0 0 0 0 0 0 4 1
1 0 0 1 1 1 1 1 1 1 1 1 1 1 1 1 1 0 0 1
1 0 4 1 0 0 0 0 0 0 0 0 0 0 0 0 4 1 0 1
1 0 0 1 0 1 1 1 1 1 1 1 0 0 4 0 0 1 0 1
1 4 0 1 0 0 0 0 0 0 0 1 0 0 0 0 0 1 0 1
1 0 0 1 1 1 1 1 1 0 0 1 1 1 1 1 0 1 0 1
1 4 0 0 0 0 0 0 0 0 4 1 0 0 0 0 0 1 0 1
1 1 1 1 1 1 1 1 1 1 1 1 4 0 4 0 4 1 0 1
1 0 0 0 0 0 0 4 0 0 0 0 0 0 0 0 0 1 0 1
1 0 0 0 0 4 0 0 0 4 0 0 0 4 0 0 0 1 X 3
2 6 0 4 0 0 0 0 0 0 0 4 0 0 0 0 0 1 0 1
1 1 1 1 1 1 1 1 1 1 1 1 1 1 1 1 1 1 1 1

1 1 1 1 1 1 1 1 1 1 1 1 1 1 1 1 1 1 1 1
1 0 0 0 4 0 0 0 0 0 0 0 0 0 0 0 0 0 X 3
1 4 0 0 0 0 0 4 0 0 1 1 1 1 1 1 1 1 1 1
1 0 0 1 1 1 1 1 1 1 1 4 0 0 0 0 0 0 6 2
1 0 0 0 4 0 0 0 0 0 1 0 0 1 1 1 1 1 1 1
1 0 0 0 0 0 0 0 0 4 1 0 4 0 0 0 0 0 0 1
1 0 0 1 1 1 1 0 0 0 1 0 0 0 0 4 0 0 4 1
1 4 0 0 0 0 1 0 0 0 1 0 0 1 1 1 1 0 0 1
1 0 0 0 0 0 1 0 4 0 1 4 0 0 0 0 0 0 0 1
1 0 4 0 0 0 1 0 4 0 1 1 1 1 1 1 1 0 0 1
1 0 0 0 0 Y 1 0 4 0 0 0 0 0 4 0 0 0 4 1
1 4 4 0 0 8 1 4 4 0 0 0 0 0 0 0 0 0 4 1
1 1 1 1 1 1 1 1 1 1 1 1 1 1 1 1 1 1 1 1

1 1 1 1 1 1 1 1 1 1 1 1 1 1 1 1 1 1 1 1
2 6 1 R 0 0 0 0 0 0 0 5 0 0 0 0 0 0 0 1
1 0 1 G 0 0 0 0 0 0 4 0 0 0 4 1 0 0 0 1
1 0 1 B 0 0 0 4 0 0 1 0 0 0 0 1 4 0 0 1
1 0 1 0 0 0 0 0 0 0 1 0 0 0 0 1 0 0 0 1
1 0 1 0 0 0 0 0 0 0 1 0 0 0 0 1 4 0 0 1
1 0 1 0 0 5 0 0 0 0 1 0 0 0 0 1 0 0 0 1
1 0 1 0 0 1 0 > 4 0 1 0 4 0 0 1 0 0 5 1
1 0 1 0 0 1 4 4 4 5 1 0 0 5 0 0 0 0 0 1
1 0 1 1 1 1 1 1 1 1 1 1 1 1 0 0 0 0 0 1
1 0 4 0 5 0 0 0 4 5 4 5 4 0 4 0 0 0 0 1
1 9 0 0 0 0 0 0 0 0 0 0 0 0 0 0 0 0 0 1
1 1 1 1 1 1 1 1 1 1 1 1 1 1 1 1 1 1 1 1