



 1 1 1 1 1 1 1 1 1 1 1 1 1 1 1 1 1 1 1 1
 1 0 R G B 0 1 0 $ * + 0 0 0 0 0 0 0 X 3
 1 0 0 0 0 0 1 0 0 0 0 0 4 0 0 0 0 0 0 1
 1 0 0 1 0 0 1 1 1 1 0 0 1 1 1 1 1 1 1 1
 1 0 0 1 0 0 0 0 0 1 0 0 0 0 0 0 0 0 0 1
 1 4 0 1 0 5 0 0 0 1 0 0 4 0 0 0 4 0 0 1
 1 0 0 1 0 0 0 0 0 1 0 0 0 0 0 1 0 0 0 1
 1 0 0 1 0 0 4 0 0 1 0 0 0 0 0 1 0 0 0 1
 1 0 4 1 0 0 0 0 0 1 0 0 0 0 0 1 0 0 0 1
 1 0 0 1 0 0 1 1 1 1 0 0 1 0 0 1 0 4 0 1
 1 0 9 1 0 0 4 0 0 4 0 0 1 0 0 5 0 0 0 1
 2 6 0 1 0 0 0 0 0 0 0 0 1 0 0 0 0 0 0 1
 1 1 1 1 1 1 1 1 1 1 1 1 1 1 1 1 1 1 1 1

 1 1 1 1 1 1 1 1 1 1 1 1 1 1 1 1 1 1 1 1
 1 $ 0 0 0 9 0 0 0 0 0 1 0 0 0 0 0 0 0 1
 1 0 0 0 0 0 0 0 0 0 0 1 0 0 0 0 0 0 0 1
 1 0 0 0 0 4 0 0 0 0 0 1 0 0 0 4 1 0 0 1
 1 0 0 0 0 1 0 0 0 0 0 1 0 0 0 0 1 0 0 1
 1 0 0 4 0 1 0 0 4 0 0 1 0 0 0 0 1 0 0 1
 1 0 0 0 0 1 0 0 0 0 0 1 0 0 0 0 1 0 4 1
 1 0 0 0 0 1 0 0 0 0 0 1 0 0 0 0 1 0 0 1
 1 0 0 0 0 1 0 0 0 0 0 1 0 0 4 0 1 0 0 1
 1 0 4 0 0 1 4 0 8 Y 0 1 0 0 0 0 1 0 0 1
 1 0 0 0 0 1 0 0 0 0 0 4 0 0 0 0 1 4 0 1
 2 6 0 4 0 1 0 0 0 0 0 0 0 0 0 0 1 0 X 3
 1 1 1 1 1 1 1 1 1 1 1 1 1 1 1 1 1 1 1 1

 1 1 1 1 1 1 1 1 1 1 1 1 1 1 1 1 1 1 1 1
 3 X < 0 1 0 0 0 0 0 0 0 0 0 0 0 0 0 0 1
 1 4 0 4 1 0 1 1 1 1 1 1 1 1 1 1 1 0 0 1
 1 0 0 0 1 0 0 0 0 0 0 0 0 0 0 0 1 0 0 1
 1 0 0 0 1 $ 0 0 0 0 0 0 0 0 0 0 1 0 0 1
 1 0 5 0 1 1 1 1 1 1 1 1 1 1 5 0 1 0 0 1
 1 0 4 0 4 0 4 0 4 0 4 0 4 0 4 0 1 0 0 1
 1 0 0 0 0 0 0 0 0 0 0 0 0 0 0 0 1 0 0 1
 1 1 1 1 1 0 4 5 4 0 1 1 1 1 0 0 1 0 0 1
 1 0 0 0 0 0 0 0 0 0 0 0 0 0 0 0 1 0 0 1
 1 1 1 1 1 1 1 0 1 1 1 1 1 1 1 1 1 5 0 1
 2 6 0 0 0 0 0 0 0 0 0 0 0 0 0 0 0 0 0 1
 1 1 1 1 1 1 1 1 1 1 1 1 1 1 1 1 1 1 1 1



 1 1 1 1 1 1 1 1 1 1 1 1 1 1 1 1 1 1 1 1
 1 0 0 0 0 0 5 0 0 0 0 5 0 0 0 0 0 0 X 3
 1 0 0 0 0 0 0 0 0 0 0 0 0 0 0 0 0 0 0 1
 1 0 0 0 0 0 0 0 0 0 0 0 0 0 0 0 0 0 0 1
 1 0 0 0 0 0 0 0 0 0 0 0 0 0 1 S O P 1 1
 1 0 0 0 0 0 0 0 0 0 0 0 0 0 1 0 H M 0 1
 1 0 0 0 0 0 0 0 0 0 0 0 0 9 1 0 0 0 0 1
 1 0 0 0 0 0 0 0 0 0 0 0 0 0 0 0 0 0 0 1
 1 $ 0 0 0 0 0 0 0 0 0 0 0 0 1 0 0 0 0 1
 1 0 0 0 0 0 0 0 0 0 0 0 0 0 1 1 1 1 1 1
 1 0 0 0 0 0 0 0 0 0 0 0 0 0 0 0 0 0 0 1
 2 6 0 5 0 0 0 0 5 0 0 0 0 0 5 0 0 0 0 1
 1 1 1 1 1 1 1 1 1 1 1 1 1 1 1 1 1 1 1 1

 1 1 1 1 1 1 1 1 1 1 1 1 1 1 1 1 1 1 1 1
 1 0 0 0 0 0 0 0 0 0 0 0 0 0 0 0 0 4 X 3
 1 0 0 4 0 0 0 0 0 4 0 0 1 0 0 4 0 0 0 1
 1 0 0 0 0 0 0 0 0 0 0 0 1 0 0 0 0 4 4 1
 1 0 0 0 0 1 0 0 0 0 0 0 1 0 0 4 0 0 0 1
 1 0 0 0 0 1 0 4 0 Y 0 0 1 0 0 0 0 0 0 1
 1 0 4 0 0 1 0 0 0 8 0 0 1 4 0 0 0 4 0 1
 1 0 0 0 0 1 0 0 4 0 0 0 0 0 0 4 0 0 0 1
 1 0 0 0 0 1 0 0 0 0 0 0 0 0 0 0 0 0 0 1
 1 0 0 4 0 1 1 1 1 1 1 1 1 1 1 1 0 0 0 1
 1 0 0 0 0 0 0 0 0 0 4 0 0 0 0 0 0 4 0 1
 2 6 0 0 0 0 0 0 0 0 0 0 0 0 4 0 0 0 0 1
 1 1 1 1 1 1 1 1 1 1 1 1 1 1 1 1 1 1 1 1

 1 2 1 3 1 1 1 1 1 1 1 1 1 1 1 1 1 1 1 1
 1 6 1 X 0 0 0 0 1 0 0 0 4 1 0 0 0 0 0 1
 1 0 1 0 0 0 0 0 0 0 1 0 0 0 0 4 1 4 0 1
 1 0 1 1 1 1 1 1 1 1 1 1 1 1 1 1 1 0 0 1
 1 0 1 0 4 0 0 0 4 0 0 0 4 0 0 0 4 0 0 1
 1 0 1 0 0 0 4 0 0 0 4 0 0 0 4 0 0 0 4 1
 1 0 1 0 = 1 1 1 1 1 1 1 1 1 1 1 1 1 1 1
 1 0 1 0 0 4 0 0 0 4 0 0 0 4 0 0 0 4 0 1
 1 0 1 4 0 0 0 4 0 0 0 4 0 0 0 4 0 0 0 1
 1 0 1 1 1 1 1 1 1 1 1 1 1 1 1 1 1 0 0 1
 1 0 0 4 0 0 0 4 0 0 0 4 0 0 0 4 0 0 0 1
 1 4 0 0 0 4 0 0 0 4 0 0 0 4 0 0 0 0 4 1
 1 1 1 1 1 1 1 1 1 1 1 1 1 1 1 1 1 1 1 1



 1 1 1 1 1 1 1 1 1 1 1 1 1 1 1 1 1 1 1 1
 1 4 0 0 0 0 0 0 0 0 0 0 0 0 0 0 0 0 0 1
 1 0 0 1 1 1 1 1 1 1 1 1 1 1 1 1 1 1 0 1
 1 0 0 1 0 0 0 0 0 0 0 0 0 0 0 0 4 1 0 1
 1 0 0 1 0 1 1 1 1 1 1 1 0 0 0 0 0 1 0 1
 1 0 0 1 0 0 0 0 0 0 0 1 0 0 0 0 0 1 0 1
 1 0 0 1 1 1 1 1 1 0 0 1 1 1 1 1 0 1 0 1
 1 0 0 0 0 0 0 0 0 0 4 1 0 0 0 0 0 1 0 1
 1 1 1 1 1 1 1 1 1 1 1 1 0 0 4 0 4 1 0 1
 3 X 0 0 0 0 0 0 0 0 0 0 0 0 0 0 0 1 0 1
 1 1 1 1 1 1 1 1 1 1 1 1 1 1 1 1 1 1 0 1
 2 6 0 0 0 0 0 0 0 0 0 0 0 0 0 0 0 0 0 1
 1 1 1 1 1 1 1 1 1 1 1 1 1 1 1 1 1 1 1 1

 1 1 1 1 1 1 1 1 1 2 1 1 1 1 1 1 1 1 1 1
 1 Y 8 0 0 0 0 0 0 6 1 4 0 0 0 0 0 0 X 3
 1 4 0 0 0 0 0 0 0 0 1 0 0 1 1 1 1 1 1 1
 1 0 0 1 1 1 1 1 1 1 1 4 0 0 0 0 0 0 0 1
 1 0 0 1 4 0 0 0 0 0 1 1 1 1 1 1 1 0 0 1
 1 0 0 1 0 0 0 0 0 4 1 4 4 0 0 0 0 0 0 1
 1 0 0 1 0 0 1 0 0 0 1 0 0 0 0 0 0 0 4 1
 1 0 0 1 0 0 1 0 0 0 1 0 0 1 1 1 1 1 1 1
 1 0 0 1 0 0 1 0 0 0 1 0 0 0 0 0 0 0 0 1
 1 0 0 1 0 0 1 0 0 0 1 1 1 1 1 1 1 0 0 1
 1 0 0 0 0 4 1 0 0 0 0 0 0 0 4 0 0 0 4 1
 1 4 4 0 0 4 1 4 4 4 0 0 0 0 0 0 0 0 4 1
 1 1 1 1 1 1 1 1 1 1 1 1 1 1 1 1 1 1 1 1

 1 1 1 1 1 1 1 1 1 1 1 1 1 1 1 1 1 1 1 1
 1 0 0 0 0 0 0 0 0 0 0 0 0 0 0 0 0 5 0 1
 1 0 0 0 0 0 0 0 0 0 4 0 0 0 0 1 0 0 0 1
 1 0 0 0 0 0 0 0 0 0 1 0 0 0 R 4 4 0 0 1
 1 0 0 0 0 0 0 0 0 9 1 0 0 0 G 4 > 0 0 1
 1 0 0 0 0 0 0 0 0 0 1 0 0 0 B 4 4 0 0 1
 1 0 0 1 1 1 1 0 0 0 1 0 0 0 0 1 0 0 0 1
 1 0 0 0 0 1 0 0 0 0 1 0 4 5 4 5 0 5 0 1
 1 0 0 0 0 1 0 0 0 0 1 0 0 0 0 0 0 0 0 1
 1 4 4 4 4 1 0 1 1 1 1 1 1 1 0 0 0 0 0 1
 1 0 0 0 5 1 0 5 4 5 4 5 4 1 0 0 0 0 0 1
 2 6 0 0 0 0 0 0 0 0 0 0 0 1 0 0 0 0 0 1
 1 1 1 1 1 1 1 1 1 1 1 1 1 1 1 1 1 1 1 1