1 1 1 1 1 1 1 1 1 1 1 1 1 1 1 1 1 1 1 1
1 0 0 0 0 0 0 0 0 0 0 0 1 0 0 0 0 4 0 3
1 0 0 4 0 0 0 0 0 4 0 0 1 0 0 4 0 0 0 1
1 0 0 0 0 0 0 0 0 0 0 0 1 0 0 0 0 4 4 1
1 0 0 0 0 6 0 0 0 0 0 0 1 0 0 4 0 0 0 1
1 0 0 0 0 1 0 4 0 0 0 0 1 0 0 0 0 0 0 1
1 0 4 0 0 1 0 0 0 0 0 0 1 4 0 0 0 4 0 1
1 0 0 0 0 1 0 0 0 0 4 0 1 0 0 0 0 0 0 1
1 0 0 0 0 1 0 0 4 0 0 0 0 0 0 4 0 0 0 1
1 0 0 0 0 1 0 0 0 0 0 0 0 0 0 0 0 0 0 1
1 0 0 4 0 1 1 1 1 1 1 1 1 1 1 6 0 0 0 1
1 0 0 0 0 0 0 0 0 0 4 0 0 0 0 0 0 4 0 1
1 0 0 0 0 4 0 0 0 0 0 0 0 0 0 0 0 0 0 1
2 8 0 0 0 0 0 0 0 0 0 0 0 0 4 0 0 0 0 1
1 1 1 1 1 1 1 1 1 1 1 1 1 1 1 1 1 1 1 1