



1 1 1 1 1 1 1 1 1 1 1 1 1 1 1 1 1 1 1 1
1 0 R G B 0 1 0 0 0 0 0 0 0 0 0 0 0 X 3
1 0 0 0 0 0 1 0 0 0 0 0 4 0 0 0 0 0 0 1
1 0 0 1 0 0 1 1 1 1 0 0 1 1 1 1 1 1 1 1
1 0 0 1 0 0 0 0 0 1 0 0 0 0 0 0 0 0 0 1
1 4 0 1 0 5 0 0 0 1 0 0 4 0 0 0 4 0 0 1
1 0 0 1 0 0 0 0 0 1 0 0 0 0 0 0 0 0 0 1
1 0 0 1 0 0 0 0 0 1 0 0 0 0 0 1 0 0 0 1
1 0 0 1 0 0 4 0 0 1 0 0 0 0 0 1 0 0 0 1
1 0 4 1 0 0 0 0 0 1 0 0 0 0 0 1 0 0 0 1
1 0 0 1 0 0 1 1 1 1 0 0 1 0 0 1 0 4 0 1
1 0 9 1 0 0 0 0 0 0 0 0 1 0 0 1 0 0 0 1
1 0 0 1 0 0 4 0 0 4 0 0 1 0 0 5 0 0 0 1
2 6 0 1 0 0 0 0 0 0 0 0 1 0 0 0 0 0 0 1
1 1 1 1 1 1 1 1 1 1 1 1 1 1 1 1 1 1 1 1

1 1 1 1 1 1 1 1 1 1 1 1 1 1 1 1 1 1 1 1
1 0 0 0 0 0 0 0 0 0 0 1 0 0 0 0 0 0 0 1
1 0 0 0 0 0 0 0 0 0 0 1 0 0 0 0 0 0 0 1
1 0 0 0 0 4 0 0 0 0 0 1 0 0 0 4 1 0 0 1
1 0 0 0 0 1 0 0 0 0 0 1 0 0 0 0 1 0 0 1
1 0 0 4 0 1 0 0 4 0 0 1 0 0 0 0 1 0 0 1
1 0 0 0 0 1 0 0 0 0 0 1 0 0 0 0 1 0 4 1
1 0 0 0 0 1 0 0 0 0 0 1 0 0 0 0 1 0 0 1
1 0 0 0 0 1 0 0 0 0 0 1 0 0 4 0 1 0 0 1
1 0 4 0 0 1 4 0 0 0 0 1 0 0 0 0 1 0 0 1
1 0 0 0 0 1 0 0 0 0 0 1 0 0 0 0 1 0 0 1
1 0 0 0 0 1 0 0 0 0 0 4 0 0 0 0 1 4 0 1
1 0 0 0 0 1 0 0 0 0 0 0 0 0 0 0 1 0 0 1
2 6 0 4 0 1 0 0 0 0 0 0 0 0 0 0 1 0 X 3
1 1 1 1 1 1 1 1 1 1 1 1 1 1 1 1 1 1 1 1

1 1 1 1 1 1 1 1 1 1 1 1 1 1 1 1 1 1 1 1
3 X 0 4 1 0 0 0 0 0 0 0 0 0 0 0 0 0 0 1
1 0 0 0 1 0 1 1 1 1 1 1 1 1 1 1 1 0 0 1
1 4 0 0 1 0 0 0 0 0 0 0 0 0 0 0 1 0 0 1
1 0 0 0 1 0 0 0 0 0 0 0 0 0 0 0 1 0 0 1
1 0 0 5 1 1 1 1 1 1 1 1 1 1 5 0 1 0 0 1
1 0 0 0 0 0 0 0 0 0 0 0 0 0 0 0 1 0 4 1
1 0 4 0 4 0 4 0 4 0 4 0 4 0 4 0 1 0 0 1
1 0 0 0 0 0 0 0 0 0 0 0 0 0 0 0 1 0 0 1
1 1 1 1 1 0 4 5 4 0 1 1 1 1 0 0 1 0 0 1
1 0 0 0 0 0 0 0 0 0 0 0 0 0 0 0 1 0 0 1
1 1 1 1 1 1 1 0 1 1 1 1 1 1 1 1 1 5 0 1
1 0 0 0 0 0 0 0 0 0 0 0 0 0 0 0 0 0 0 1
2 6 0 4 0 0 0 0 0 0 0 0 0 0 0 0 0 0 0 1
1 1 1 1 1 1 1 1 1 1 1 1 1 1 1 1 1 1 1 1



1 1 1 1 1 1 1 1 1 1 1 1 1 1 1 1 1 1 1 1
1 0 0 0 0 0 5 0 0 0 0 5 0 0 0 0 0 0 X 3
1 0 0 0 0 0 0 0 0 0 0 0 0 0 0 0 0 0 0 1
1 0 0 0 0 0 0 0 0 0 0 0 0 0 0 0 0 0 0 1
1 0 0 0 0 0 0 0 0 0 0 0 0 0 0 0 0 0 0 1
1 0 0 0 0 0 0 0 0 0 0 0 0 0 0 0 0 0 0 1
1 0 0 0 0 0 0 0 0 0 0 0 0 0 0 0 0 0 0 1
1 0 0 0 0 0 0 0 0 0 0 0 0 0 0 0 0 0 0 1
1 0 0 0 0 0 0 0 0 0 0 0 0 0 0 0 0 0 0 1
1 0 0 0 0 0 0 0 0 0 0 0 0 0 0 0 0 0 0 1
1 0 0 0 0 0 0 0 0 0 0 0 0 0 0 0 0 0 0 1
1 0 0 0 0 0 0 0 0 0 0 0 0 0 0 0 0 0 0 1
1 0 0 0 0 0 0 0 0 0 0 0 0 0 0 0 0 0 0 1
2 6 0 5 0 0 0 0 5 0 0 0 0 0 5 0 0 0 0 1
1 1 1 1 1 1 1 1 1 1 1 1 1 1 1 1 1 1 1 1

1 1 1 1 1 1 1 1 1 1 1 1 1 1 1 1 1 1 1 1
1 0 0 0 0 0 0 0 0 0 0 0 1 0 0 0 0 4 0 3
1 0 0 4 0 0 0 0 0 4 0 0 1 0 0 4 0 0 0 1
1 0 0 0 0 0 0 0 0 0 0 0 1 0 0 0 0 4 4 1
1 0 0 0 0 6 0 0 0 0 0 0 1 0 0 4 0 0 0 1
1 0 0 0 0 1 0 4 0 0 0 0 1 0 0 0 0 0 0 1
1 0 4 0 0 1 0 0 0 0 0 0 1 4 0 0 0 4 0 1
1 0 0 0 0 1 0 0 0 0 4 0 1 0 0 0 0 0 0 1
1 0 0 0 0 1 0 0 4 0 0 0 0 0 0 4 0 0 0 1
1 0 0 0 0 1 0 0 0 0 0 0 0 0 0 0 0 0 0 1
1 0 0 4 0 1 1 1 1 1 1 1 1 1 1 6 0 0 0 1
1 0 0 0 0 0 0 0 0 0 4 0 0 0 0 0 0 4 0 1
1 0 0 0 0 4 0 0 0 0 0 0 0 0 0 0 0 0 0 1
2 8 0 0 0 0 0 0 0 0 0 0 0 0 4 0 0 0 0 1
1 1 1 1 1 1 1 1 1 1 1 1 1 1 1 1 1 1 1 1

1 2 1 3 1 1 1 1 1 1 1 1 1 1 1 1 1 1 1 1
1 8 1 0 0 0 0 0 1 0 0 0 4 1 0 0 0 0 4 1
1 0 1 0 4 4 4 0 1 0 0 0 0 1 4 0 0 0 0 1
1 0 1 0 4 4 4 0 0 0 1 4 0 0 0 0 1 0 0 1
1 0 1 0 0 0 0 0 0 0 1 0 0 0 0 4 1 4 0 1
1 0 1 1 1 1 1 1 1 1 1 1 1 1 1 1 1 0 0 1
1 0 1 0 4 0 0 0 4 0 0 0 4 0 0 0 4 0 0 1
1 0 1 0 0 0 4 0 0 0 4 0 0 0 4 0 0 0 4 1
1 0 1 0 0 1 1 1 1 1 1 1 1 1 1 1 1 1 1 1
1 0 1 0 0 4 0 0 0 4 0 0 0 4 0 0 0 4 0 1
1 0 1 4 0 0 0 4 0 0 0 4 0 0 0 4 0 0 0 1
1 0 1 1 1 1 1 1 1 1 1 1 1 1 1 1 1 0 0 1
1 0 0 4 0 0 0 4 0 0 0 4 0 0 0 4 0 0 0 1
1 4 0 0 0 4 0 0 0 4 0 0 0 4 0 0 0 0 4 1
1 1 1 1 1 1 1 1 1 1 1 1 1 1 1 1 1 1 1 1



1 1 1 1 1 1 1 1 1 1 1 1 1 1 1 1 1 1 1 1
1 4 0 0 0 0 0 0 0 0 0 0 0 0 0 0 0 0 0 1
1 0 0 1 1 1 1 1 1 1 1 1 1 1 1 1 1 1 0 1
1 0 0 1 4 0 0 0 0 0 0 0 0 0 0 0 4 1 0 1
1 0 0 1 0 0 0 0 0 0 5 0 0 0 0 0 4 1 0 1
1 0 0 1 0 1 1 1 1 1 1 1 0 0 0 0 0 1 0 1
1 0 0 1 0 0 0 0 0 0 0 1 0 0 0 0 0 1 0 1
1 0 0 1 1 1 1 1 1 0 0 1 1 1 1 1 0 1 0 1
1 0 0 4 0 0 0 0 0 0 0 1 4 0 0 0 0 1 0 1
1 0 0 0 0 0 0 0 0 0 4 1 0 0 0 0 4 1 0 1
1 1 1 1 1 1 1 1 1 1 1 1 0 0 4 0 0 1 0 1
3 0 0 0 0 0 0 0 0 0 0 0 0 0 0 0 0 1 0 1
1 1 1 1 1 1 1 1 1 1 1 1 1 1 1 1 1 1 0 1
2 8 0 0 0 0 0 0 0 0 0 0 0 0 0 0 0 0 0 1
1 1 1 1 1 1 1 1 1 1 1 1 1 1 1 1 1 1 1 1

1 1 1 1 1 1 1 1 1 2 1 1 1 1 1 1 1 1 1 1
1 0 0 0 0 0 0 0 0 8 1 4 0 0 0 0 0 0 0 3
1 4 0 0 0 0 0 0 0 0 1 0 0 1 1 1 1 1 1 1
1 0 0 0 0 0 0 0 0 4 1 0 0 0 0 0 0 4 0 1
1 0 0 1 1 1 1 1 1 1 1 4 0 0 0 0 0 0 0 1
1 0 0 1 4 0 0 0 0 0 1 1 1 1 1 1 1 0 0 1
1 0 0 1 0 0 0 0 0 4 1 4 4 0 0 0 0 0 0 1
1 0 0 1 0 0 1 0 0 0 1 0 0 0 0 0 0 0 4 1
1 0 0 1 0 0 1 0 0 0 1 0 0 1 1 1 1 1 1 1
1 0 0 1 0 0 1 0 0 0 1 0 0 0 0 0 0 4 0 1
1 0 0 1 0 0 1 0 0 0 1 4 0 0 0 0 0 0 0 1
1 0 0 1 0 0 1 0 0 0 1 1 1 1 1 1 1 0 0 1
1 0 0 0 0 4 1 0 0 0 0 0 0 0 4 0 0 0 4 1
1 4 4 0 0 4 1 4 4 4 0 0 0 0 0 0 0 0 4 1
1 1 1 1 1 1 1 1 1 1 1 1 1 1 1 1 1 1 1 1

1 1 1 1 1 1 1 1 1 1 1 1 1 1 1 1 1 1 1 1
1 0 0 0 0 0 0 0 0 0 0 0 0 0 0 0 0 0 0 3
1 0 0 0 0 0 0 0 0 0 0 0 0 0 0 0 0 0 0 1
1 0 0 0 0 0 0 0 0 0 0 0 0 0 0 0 0 0 0 1
1 0 0 0 0 0 0 0 0 0 0 0 0 0 0 0 0 0 0 1
1 0 0 0 0 0 0 0 0 0 0 0 0 0 0 0 0 0 0 1
1 0 0 0 0 0 0 0 0 0 0 0 0 0 0 0 0 0 0 1
1 0 0 0 0 0 0 0 0 0 0 0 0 0 0 0 0 0 0 1
1 0 0 0 0 0 0 0 0 0 0 0 0 0 0 0 0 0 0 1
1 0 0 0 0 0 0 0 0 0 0 0 0 0 0 0 0 0 0 1
1 0 0 0 0 0 0 0 0 0 0 0 0 0 0 0 0 0 0 1
1 0 0 0 0 0 0 0 0 0 0 0 0 0 0 0 0 0 0 1
1 0 0 0 0 0 0 0 0 0 0 0 0 0 0 0 0 0 0 1
2 8 0 0 0 0 0 0 0 0 0 0 0 0 0 0 0 0 0 1
1 1 1 1 1 1 1 1 1 1 1 1 1 1 1 1 1 1 1 1